111111111111111111111111111
100011111111111111111110001
101001111111111111111100101
101100000000000000000001101
101110011111101111110011101
101111001111101111100111101
101111100111101111C01111101
101111110C11101110011111101
1011111110N1101100111111101
101111111100101001111111101
101111111110000001111111101
10111111111100N011111111101
101111111111100111111111101
101111111111100111111111101
101111000000000000000011101
101111000000000000000011101
101111000C00000000C00011101
101111000000000000000011101
1P1111N000000CC000000N1E001
111111111111111111111111111