11111111111111111111111111
11111111111111111111111111
10000P00000C00000110000001
10001111111C0110E000111011
10000000000000C000000000C1
11111111111111111111111111