11111111111111111111111111111111111111111111111111111111111111111111111111111111111111111111111111111111
1111110P0000000000000000000011111111111111100000000000C00C000000C000C00000000000111111111111111111111111
100000011111111111111111000011111111111111100000000C000000001100000000C000000000000000000000111111111111
1111111111111111111111110000111111111111111000000C0000000000111100000000C0000000000000000000011111111111
11111111111111111111111100001111111111111110000C00000000001111110000000000C00000111111110111111111111111
1111111111111111111111110000000000C0000000000C000000000001111111100000000000C000011111110111111111111111
1111111111111111111111110000000000000000C0000000000000000000000000000000000000C00111111100000000000000E1
11111111111111111111111111111111111111111111111111111111111111111111111111111111111111111111111111111111
