11111111111111111111111111
100000P0000C00001110000001
10001111111C011000000C0001
100000C0000001111111111111
10000X00000000C000000000E1
11111111111111111111111111